{
  "Levels": [
    {
      "LevelNumber": 1,
      "IsFinished": false,
      "Map":  [
        {
          "row01": "!!!!!!!!!!",
          "row02": "!!!!!!!!!!",
          "row03": "!!######!!",
          "row04": "!!#  @ #!!",
          "row05": "!!#$####!!",
          "row06": "!!# #!!!!!",
          "row07": "!!#.#!!!!!",
          "row08": "!!###!!!!!",
          "row09": "!!!!!!!!!!",
          "row10": "!!!!!!!!!!"
        }
      ]
    },
    {
      "LevelNumber": 2,
      "IsFinished": false,
      "Map":  [
        {
          "row01": "!!!!!!!!!!",
          "row02": "!!!!!!!!!!",
          "row03": "!!######!!",
          "row04": "!!#@   #!!",
          "row05": "!!#  $.#!!",
          "row06": "!!# .$ #!!",
          "row07": "!!######!!",
          "row08": "!!!!!!!!!!",
          "row09": "!!!!!!!!!!",
          "row10": "!!!!!!!!!!"
        }
      ]
    }
  ]
}